2402222222222222
2400000000000002
2400000300000002
2400000000000002
2400000000030002
2400000000000002
2400000030000002
2400000000000002
2400000000030002
2400000000000002
2111111111111111
2222222222222222