2 4 0 2 2 2 2 2 2 2 2 2 2 2 2 2
2 4 0 0 0 0 0 0 0 0 0 0 0 0 0 2
2 4 0 0 0 0 0 3 0 0 0 0 0 0 0 2
2 4 0 0 0 0 0 0 0 0 0 0 0 0 0 2
2 4 0 0 0 0 0 0 0 0 0 3 0 0 0 2
2 4 0 0 0 0 0 0 0 0 0 0 0 0 0 2
2 4 0 0 0 0 0 0 3 0 0 0 0 0 0 2
2 4 0 0 0 0 0 0 0 0 0 0 0 0 0 2
2 4 0 0 0 0 0 0 0 0 0 3 0 0 0 2
2 4 0 0 0 0 0 0 0 0 0 0 0 0 0 2
2 1 1 1 1 1 1 1 1 1 1 1 1 1 1 1
2 2 2 2 2 2 2 2 2 2 2 2 2 2 2 2